{
    "F1": 1,
    "F2": 1,
    "F3": 1,
    "F4": 1,
    "F5": 1,
    "F6": 1,
    "F7": 1,
    "F8": 1,
    "F9": 1,
    "L10": 1,
    "L11": 1,
    "L12": 1,
    "L13": 1
}
